25 24 24 24 24 24 24 24 24 24 24 24 24 24 25
18 0 1 1 1 1 1 1 1 1 1 1 1 2 20
18 3 4 4 4 4 4 4 4 4 4 4 4 5 20
18 6 7 7 7 7 7 7 7 7 7 7 7 8 20
18 9 9 9 9 9 9 9 9 9 9 9 9 9 20
18 9 11 10 11 10 11 10 11 10 11 10 11 9 20
29 9 10 11 10 11 10 11 10 11 10 11 10 9 27
2 9 11 10 11 10 11 10 11 10 11 10 11 9 0
5 9 10 11 10 11 10 11 10 11 10 11 10 9 3
8 9 11 10 11 10 11 10 11 10 11 10 11 9 6
9 9 9 9 9 9 9 9 9 9 9 9 9 9 9 
